わ  吾－れ  
わ  我－が	
あお－い	青
あお－ぐ	仰
あか－い	赤
あか－らむ	明
あか－らむ	赤
あか－らめる	赤
あか－るい	明
あか－るむ	明
あきな－う	商
あき－らか	明
あさ－い	浅
あざむ－く	欺
あざ－やか	鮮
あじ－わう	味
あず－かる	預
あず－ける	預
あせ－る	焦
あそ－ぶ	遊
あたた－か	暖
あたた－か	温
あたた－かい	暖
あたた－かい	温
あたた－まる	暖
あたた－まる	温
あたた－める	暖
あたた－める	温
あたら－しい	新
あた－える	与
あた－り	辺
あつか－う	扱
あつ－い	厚
あつ－い	暑
あつ－い	熱
あつ－まる	集
あつ－める	集
あなど－る	侮
あば－く	暴
あば－れる	暴
あぶ－ない	危
あま－い	甘
あま－える	甘
あま－す	余
あま－やかす	甘
あま－る	余
あやつ－る	操
あやま－ち	過
あやま－つ	過
あやま－る	誤
あやま－る	謝
あや－うい	危
あや－しい	怪
あや－しむ	怪
あや－ぶむ	危
あゆ－む	歩
あらそ－う	争
あらた－まる	改
あらた－める	改
あらわ－す	現
あらわ－す	著
あらわ－す	表
あらわ－れる	現
あらわ－れる	表
あら－い	粗
あら－い	荒
あら－う	洗
あら－た	新
ある－く	歩
あわ－い	淡
あわ－せる	併
あわ－ただしい	慌
あわ－てる	慌
あわ－れ	哀
あわ－れむ	哀
あ－う	会
あ－う	合
あ－う	遭
あ－かす	明
あ－かす	飽
あ－かり	明
あ－がる	上
あ－がる	挙
あ－がる	揚
あ－きる	飽
あ－く	明
あ－く	空
あ－く	開
あ－くる	明
あ－ける	明
あ－ける	空
あ－ける	開
あ－げる	上
あ－げる	挙
あ－げる	揚
あ－たる	当
あ－てる	充
あ－てる	宛
あ－てる	当
あ－びせる	浴
あ－びる	浴
あ－む	編
あ－らす	荒
あ－る	在
あ－る	有
あ－れる	荒
あ－わす	合
あ－わせる	合
いか－る	怒
いきお－い	勢
いきどお－る	憤
いこ－い	憩
いこ－う	憩
いさぎよ－い	潔
いさ－む	勇
いそが－しい	忙
いそ－ぐ	急
いただ－く	頂
いた－い	痛
いた－す	致
いた－む	傷
いた－む	悼
いた－む	痛
いた－める	傷
いた－める	痛
いた－る	至
いだ－く	抱
いちじる－しい	著
いつく－しむ	慈
いつわ－る	偽
いつ－つ	五
いとな－む	営
いど－む	挑
いの－る	祈
いまし－める	戒
いや－しい	卑
いや－しむ	卑
いや－しめる	卑
いろど－る	彩
いわ－う	祝
い－う	言
い－える	癒
い－かす	生
い－きる	生
い－く	行
い－く	逝
い－ける	生
い－まわしい	忌
い－む	忌
い－やす	癒
い－る	入
い－る	射
い－る	居
い－る	要
い－る	鋳
い－れる	入
うかが－う	伺
うけたまわ－る	承
うご－かす	動
うご－く	動
うしな－う	失
うし－ろ	後
うす－い	薄
うす－まる	薄
うす－める	薄
うす－らぐ	薄
うす－れる	薄
うたが－う	疑
うた－う	歌
うた－う	謡
うった－える	訴
うつく－しい	美
うつ－す	写
うつ－す	映
うつ－す	移
うつ－る	写
うつ－る	映
うつ－る	移
うと－い	疎
うと－む	疎
うなが－す	促
うば－う	奪
うやうや－しい	恭
うやま－う	敬
うらな－う	占
うらや－ましい	羨
うらや－む	羨
うら－む	恨
うら－めしい	恨
うるお－う	潤
うるお－す	潤
うるわ－しい	麗
うる－む	潤
うれ－い	愁
うれ－い	憂
うれ－える	愁
うれ－える	憂
う－い	憂
う－える	植
う－える	飢
う－かぶ	浮
う－かべる	浮
う－かる	受
う－かれる	浮
う－く	浮
う－ける	受
う－ける	請
う－つ	打
う－つ	撃
う－つ	討
う－まる	埋
う－まれる	生
う－まれる	産
う－む	生
う－む	産
う－める	埋
う－もれる	埋
う－る	売
う－る	得
う－れる	売
う－れる	熟
う－わる	植
えが－く	描
えら－い	偉
えら－ぶ	選
え－む	笑
え－る	得
え－る	獲
おお－い	多
おお－いに	大
おお－う	覆
おお－きい	大
おお－せ	仰
おか－す	侵
おか－す	冒
おか－す	犯
おが－む	拝
おぎな－う	補
おく－らす	遅
おく－る	贈
おく－る	送
おく－れる	後
おく－れる	遅
おこた－る	怠
おこな－う	行
おこ－す	興
おこ－る	怒
おこ－る	興
おごそ－か	厳
おさな－い	幼
おさ－える	抑
おさ－まる	修
おさ－まる	収
おさ－まる	治
おさ－まる	納
おさ－める	修
おさ－める	収
おさ－める	治
おさ－める	納
おし－える	教
おそ－い	遅
おそ－う	襲
おそ－れる	恐
おそ－ろしい	恐
おそ－わる	教
おだ－やか	穏
おちい－る	陥
おとしい－れる	陥
おとず－れる	訪
おとろ－える	衰
おと－る	劣
おどろ－かす	驚
おどろ－く	驚
おど－かす	脅
おど－す	脅
おど－り	踊
おど－る	踊
おど－る	躍
おな－じ	同
おびや－かす	脅
おぼ－える	覚
おもむ－く	赴
おも－い	重
おも－う	思
およ－ぐ	泳
およ－び	及
およ－ぶ	及
およ－ぼす	及
おろ－か	愚
おろ－す	卸
お－いる	老
お－う	生
お－う	負
お－う	追
お－える	終
お－きる	起
お－く	置
お－こす	起
お－こる	起
お－さえる	押
お－しい	惜
お－しむ	惜
お－す	押
お－す	推
お－ちる	落
お－とす	落
お－びる	帯
お－りる	下
お－りる	降
お－る	折
お－る	織
お－れる	折
お－ろす	下
お－ろす	降
お－わる	終
かえり－みる	省
かえり－みる	顧
かえ－す	帰
かえ－す	返
かえ－る	帰
かえ－る	返
かお－り	香
かお－る	薫
かお－る	香
かか－える	抱
かか－げる	掲
かか－る	係
かか－わる	関
かがや－く	輝
かぎ－る	限
かく－す	隠
かく－れる	隠
かげ－る	陰
かこ－う	囲
かこ－む	囲
かさ－なる	重
かさ－ねる	重
かざ－る	飾
かしこ－い	賢
かせ－ぐ	稼
かぞ－える	数
かたむ－く	傾
かたむ－ける	傾
かたよ－る	偏
かたわ－ら	傍
かた－い	固
かた－い	堅
かた－い	硬
かた－い	難
かた－まる	固
かた－める	固
かた－らう	語
かた－る	語
かつ－ぐ	担
かなら－ず	必
かな－しい	悲
かな－しむ	悲
かな－でる	奏
かま－う	構
かま－える	構
かも－す	醸
かよ－う	通
から－い	辛
から－まる	絡
から－む	絡
から－める	絡
かる－い	軽
かろ－やか	軽
かわ－かす	乾
かわ－く	乾
かわ－く	渇
かんが－える	考
かんが－みる	鑑
かんば－しい	芳
か－う	交
か－う	買
か－う	飼
か－える	代
か－える	変
か－える	換
か－える	替
か－かる	懸
か－かる	掛
か－かる	架
か－く	描
か－く	書
か－く	欠
か－ける	懸
か－ける	掛
か－ける	架
か－ける	欠
か－ける	賭
か－ける	駆
か－す	貸
か－つ	且
か－つ	勝
か－ねる	兼
か－らす	枯
か－り	狩
か－りる	借
か－る	刈
か－る	狩
か－る	駆
か－れる	枯
か－わす	交
か－わる	代
か－わる	変
か－わる	換
か－わる	替
きざ－し	兆
きざ－す	兆
きざ－む	刻
きず－く	築
きそ－う	競
きたな－い	汚
きた－える	鍛
きた－す	来
きた－る	来
きび－しい	厳
きよ－い	清
きよ－まる	清
きよ－める	清
きら－う	嫌
きわ－まる	極
きわ－まる	窮
きわ－み	極
きわ－める	極
きわ－める	究
きわ－める	窮
き－える	消
き－く	利
き－く	効
き－く	聞
き－く	聴
き－こえる	聞
き－せる	着
き－まる	決
き－める	決
き－る	切
き－る	着
き－れる	切
くさ－い	臭
くさ－らす	腐
くさ－る	腐
くさ－れる	腐
くず－す	崩
くず－れる	崩
くだ－く	砕
くだ－ける	砕
くだ－さる	下
くだ－す	下
くだ－る	下
くつがえ－す	覆
くつがえ－る	覆
くば－る	配
くも－る	曇
くや－しい	悔
くら－い	暗
くら－べる	比
くる－う	狂
くる－おしい	狂
くる－しい	苦
くる－しむ	苦
くる－しめる	苦
くろ－い	黒
くわだ－てる	企
くわ－える	加
くわ－しい	詳
くわ－わる	加
く－いる	悔
く－う	食
く－ちる	朽
く－む	組
く－む	酌
く－やむ	悔
く－らう	食
く－らす	暮
く－る	来
く－る	繰
く－れる	暮
けが－す	汚
けが－らわしい	汚
けが－れる	汚
けず－る	削
けむ－い	煙
けむ－る	煙
けわ－しい	険
け－す	消
こい－しい	恋
こうむ－る	被
こお－る	凍
ここの－つ	九
こころざ－す	志
こころよ－い	快
こころ－みる	試
こご－える	凍
こた－え	答
こた－える	応
こた－える	答
ことわ－る	断
この－む	好
こば－む	拒
こま－か	細
こま－かい	細
こま－る	困
ころ－がす	転
ころ－がる	転
ころ－げる	転
ころ－す	殺
ころ－ぶ	転
こわ－い	怖
こわ－す	壊
こわ－れる	壊
こ－い	濃
こ－う	乞
こ－う	恋
こ－う	請
こ－える	肥
こ－える	超
こ－える	越
こ－がす	焦
こ－がれる	焦
こ－げる	焦
こ－す	超
こ－す	越
こ－む	混
こ－む	込
こ－める	込
こ－やし	肥
こ－やす	肥
こ－らしめる	懲
こ－らす	凝
こ－らす	懲
こ－りる	懲
こ－る	凝
さいわ－い	幸
さえぎ－る	遮
さか－える	栄
さか－らう	逆
さか－る	盛
さか－ん	盛
さが－す	捜
さが－す	探
さぐ－る	探
さけ－ぶ	叫
ささ－える	支
さず－かる	授
さず－ける	授
さそ－う	誘
さだ－か	定
さだ－まる	定
さだ－める	定
さと－す	諭
さと－る	悟
さば－く	裁
さび－しい	寂
さび－れる	寂
さまた－げる	妨
さむ－い	寒
さわ－ぐ	騒
さわ－る	触
さわ－る	障
さ－がる	下
さ－く	割
さ－く	咲
さ－く	裂
さ－ける	裂
さ－ける	避
さ－げる	下
さ－げる	提
さ－さる	刺
さ－す	刺
さ－す	差
さ－す	指
さ－す	挿
さ－ます	冷
さ－ます	覚
さ－める	冷
さ－める	覚
さ－る	去
しあわ－せ	幸
しいた－げる	虐
しげ－る	茂
しず－か	静
しず－まる	鎮
しず－まる	静
しず－む	沈
しず－める	沈
しず－める	鎮
しず－める	静
したが－う	従
したが－える	従
したた－る	滴
した－う	慕
した－しい	親
した－しむ	親
しの－ばせる	忍
しの－ぶ	忍
しば－る	縛
しぶ－い	渋
しぶ－る	渋
しぼ－る	搾
しぼ－る	絞
しめ－す	湿
しめ－す	示
しめ－る	湿
しら－べる	調
しりぞ－く	退
しりぞ－ける	退
しる－す	記
しろ－い	白
し－いる	強
し－く	敷
し－ぬ	死
し－まる	絞
し－まる	締
し－まる	閉
し－み	染
し－みる	染
し－める	占
し－める	絞
し－める	締
し－める	閉
し－る	知
すく－う	救
すく－ない	少
すぐ－れる	優
すこ－し	少
すこ－やか	健
すす－む	進
すす－める	勧
すす－める	薦
すす－める	進
すず－しい	涼
すず－む	涼
すた－る	廃
すた－れる	廃
すで－に	既
すべ－て	全
すべ－る	滑
すみ－やか	速
するど－い	鋭
すわ－る	座
す－い	酸
す－う	吸
す－える	据
す－かす	透
す－ぎる	過
す－く	好
す－く	透
す－ける	透
す－ごす	過
す－てる	捨
す－べる	統
す－まう	住
す－ます	済
す－ます	澄
す－む	住
す－む	済
す－む	澄
す－る	刷
す－る	擦
す－れる	擦
す－わる	据
せば－まる	狭
せば－める	狭
せま－い	狭
せま－る	迫
せ－める	攻
せ－める	責
せ－る	競
そこ－なう	損
そこ－ねる	損
そそのか－す	唆
そそ－ぐ	注
そだ－つ	育
そだ－てる	育
そな－える	供
そな－える	備
そな－わる	備
そむ－く	背
そむ－ける	背
そ－う	沿
そ－う	添
そ－える	添
そ－まる	染
そ－める	初
そ－める	染
そ－らす	反
そ－る	反
たい－ら	平
たお－す	倒
たお－れる	倒
たか－い	高
たか－まる	高
たか－める	高
たがや－す	耕
たが－い	互
たくわ－える	蓄
たく－み	巧
たぐ－い	類
たし－か	確
たし－かめる	確
たす－かる	助
たす－ける	助
たずさ－える	携
たずさ－わる	携
たず－ねる	尋
たず－ねる	訪
たたか－う	戦
たたか－う	闘
たた－む	畳
ただよ－う	漂
ただ－し	但
ただ－しい	正
ただ－す	正
ただ－ちに	直
たっと－い	尊
たっと－い	貴
たっと－ぶ	尊
たっと－ぶ	貴
たてまつ－る	奉
たと－える	例
たの－しい	楽
たの－しむ	楽
たの－む	頼
たの－もしい	頼
たまわ－る	賜
ため－す	試
たも－つ	保
たよ－り	便
たよ－る	頼
たわむ－れる	戯
た－える	堪
た－える	絶
た－える	耐
た－く	炊
た－す	足
た－つ	建
た－つ	断
た－つ	立
た－つ	絶
た－つ	裁
た－てる	建
た－てる	立
た－べる	食
た－める	矯
た－やす	絶
た－らす	垂
た－りる	足
た－る	足
た－れる	垂
だま－る	黙
だ－く	抱
だ－す	出
ちい－さい	小
ちか－い	近
ちか－う	誓
ちが－う	違
ちが－える	違
ちぎ－る	契
ちぢ－まる	縮
ちぢ－む	縮
ちぢ－める	縮
ちぢ－らす	縮
ちぢ－れる	縮
ち－らかす	散
ち－らかる	散
ち－らす	散
ち－る	散
つい－える	費
つい－やす	費
つか－う	使
つか－う	遣
つか－える	仕
つか－まえる	捕
つか－まる	捕
つか－れる	疲
つか－わす	遣
つくろ－う	繕
つく－る	作
つく－る	創
つく－る	造
つぐな－う	償
つたな－い	拙
つた－う	伝
つた－える	伝
つた－わる	伝
つちか－う	培
つつし－む	慎
つつし－む	謹
つつ－む	包
つづ－く	続
つづ－ける	続
つと－まる	務
つと－まる	勤
つと－める	努
つと－める	務
つと－める	勤
つど－う	集
つの－る	募
つむ－ぐ	紡
つめ－たい	冷
つよ－い	強
つよ－まる	強
つよ－める	強
つらぬ－く	貫
つら－なる	連
つら－ねる	連
つ－かす	尽
つ－かる	漬
つ－きる	尽
つ－く	付
つ－く	就
つ－く	着
つ－く	突
つ－くす	尽
つ－ぐ	接
つ－ぐ	次
つ－ぐ	継
つ－ける	付
つ－ける	就
つ－ける	漬
つ－ける	着
つ－げる	告
つ－まる	詰
つ－む	摘
つ－む	積
つ－む	詰
つ－める	詰
つ－もる	積
つ－る	釣
つ－れる	連
て－らす	照
て－る	照
て－れる	照
で－る	出
とうと－い	尊
とうと－い	貴
とうと－ぶ	尊
とうと－ぶ	貴
とお－い	遠
とお－す	通
とお－る	通
とつ－ぐ	嫁
ととの－う	整
ととの－う	調
ととの－える	整
ととの－える	調
とどこお－る	滞
とど－く	届
とど－ける	届
とな－える	唱
とな－る	隣
とぼ－しい	乏
とむら－う	弔
ともな－う	伴
と－い	問
と－う	問
と－かす	溶
と－かす	解
と－く	溶
と－く	解
と－く	説
と－ぐ	研
と－ける	溶
と－ける	解
と－げる	遂
と－ざす	閉
と－じる	閉
と－ばす	飛
と－ぶ	跳
と－ぶ	飛
と－まる	止
と－まる	泊
と－まる	留
と－む	富
と－める	止
と－める	泊
と－める	留
と－らえる	捕
と－らわれる	捕
と－る	取
と－る	執
と－る	捕
と－る	採
と－る	撮
なお－す	治
なお－す	直
なお－る	治
なお－る	直
なか－ば	半
なが－い	永
なが－い	長
なが－す	流
なが－める	眺
なが－れる	流
なぐさ－む	慰
なぐさ－める	慰
なぐ－る	殴
なげ－かわしい	嘆
なげ－く	嘆
なご－む	和
なご－やか	和
なさ－け	情
なつ－かしい	懐
なつ－かしむ	懐
なつ－く	懐
なつ－ける	懐
なな－つ	七
なな－め	斜
なま－ける	怠
なめ－らか	滑
なや－ます	悩
なや－む	悩
なら－う	倣
なら－う	習
なら－びに	並
なら－ぶ	並
なら－べる	並
な－い	亡
な－い	無
な－く	泣
な－く	鳴
な－げる	投
な－す	成
な－らす	慣
な－らす	鳴
な－る	成
な－る	鳴
な－れる	慣
にお－う	臭
にが－い	苦
にが－る	苦
にぎ－る	握
にく－い	憎
にく－しみ	憎
にく－む	憎
にく－らしい	憎
にご－す	濁
にご－る	濁
にな－う	担
にぶ－い	鈍
にぶ－る	鈍
に－える	煮
に－がす	逃
に－げる	逃
に－やす	煮
に－る	似
に－る	煮
ぬす－む	盗
ぬ－う	縫
ぬ－かす	抜
ぬ－かる	抜
ぬ－く	抜
ぬ－ぐ	脱
ぬ－ける	抜
ぬ－げる	脱
ぬ－る	塗
ねが－う	願
ねば－る	粘
ねむ－い	眠
ねむ－る	眠
ねんご－ろ	懇
ね－かす	寝
ね－る	寝
ね－る	練
のが－す	逃
のが－れる	逃
のこ－す	残
のこ－る	残
のぞ－く	除
のぞ－む	望
のぞ－む	臨
のぼ－す	上
のぼ－せる	上
のぼ－る	上
のぼ－る	昇
のぼ－る	登
の－せる	乗
の－せる	載
の－ばす	伸
の－ばす	延
の－びる	伸
の－びる	延
の－べる	伸
の－べる	延
の－べる	述
の－む	飲
の－る	乗
の－る	載
はい－る	入
はか－らう	計
はか－る	図
はか－る	測
はか－る	計
はか－る	諮
はか－る	謀
はか－る	量
はぐく－む	育
はげ－しい	激
はげ－ます	励
はげ－む	励
はこ－ぶ	運
はさ－まる	挟
はさ－む	挟
はし－る	走
はじ－まる	始
はじ－め	初
はじ－めて	初
はじ－める	始
はずかし－める	辱
はず－す	外
はず－む	弾
はず－れる	外
はたら－く	働
はなは－だ	甚
はなは－だしい	甚
はな－す	放
はな－す	話
はな－す	離
はな－つ	放
はな－れる	放
はな－れる	離
はば－む	阻
はぶ－く	省
はや－い	早
はや－い	速
はや－まる	早
はや－まる	速
はや－める	早
はや－める	速
はら－う	払
は－え	栄
は－える	映
は－える	栄
は－える	生
は－く	吐
は－く	履
は－く	掃
は－じらう	恥
は－じる	恥
は－ずかしい	恥
は－たす	果
は－て	果
は－てる	果
は－ねる	跳
は－やす	生
は－らす	晴
は－る	張
は－れる	晴
ば－かす	化
ば－ける	化
ひい－でる	秀
ひか－える	控
ひか－る	光
ひき－いる	率
ひく－い	低
ひく－まる	低
ひく－める	低
ひさ－しい	久
ひそ－む	潜
ひた－す	浸
ひた－る	浸
ひと－しい	等
ひと－つ	一
ひと－り	独
ひび－く	響
ひら－く	開
ひら－ける	開
ひるがえ－す	翻
ひるがえ－る	翻
ひろ－い	広
ひろ－う	拾
ひろ－がる	広
ひろ－げる	広
ひろ－まる	広
ひろ－める	広
ひ－える	冷
ひ－く	引
ひ－く	弾
ひ－ける	引
ひ－める	秘
ひ－や	冷
ひ－やかす	冷
ひ－やす	冷
ひ－る	干
ふか－い	深
ふか－まる	深
ふか－める	深
ふく－む	含
ふく－める	含
ふく－らむ	膨
ふく－れる	膨
ふせ－ぐ	防
ふたた－び	再
ふた－つ	二
ふと－い	太
ふと－る	太
ふる－い	古
ふる－う	奮
ふる－う	震
ふる－える	震
ふる－す	古
ふ－える	増
ふ－える	殖
ふ－かす	更
ふ－く	吹
ふ－く	噴
ふ－ける	更
ふ－ける	老
ふ－す	伏
ふ－せる	伏
ふ－まえる	踏
ふ－む	踏
ふ－やす	増
ふ－やす	殖
ふ－る	振
ふ－る	降
ふ－るう	振
ふ－れる	振
ふ－れる	触
へだ－たる	隔
へだ－てる	隔
へ－らす	減
へ－る	減
へ－る	経
ほうむ－る	葬
ほう－る	放
ほが－らか	朗
ほこ－る	誇
ほそ－い	細
ほそ－る	細
ほっ－する	欲
ほどこ－す	施
ほま－れ	誉
ほろ－びる	滅
ほろ－ぼす	滅
ほ－しい	欲
ほ－す	干
ほ－める	褒
ほ－る	彫
ほ－る	掘
まい－る	参
まかな－う	賄
まか－す	任
まか－せる	任
まぎ－らす	紛
まぎ－らわしい	紛
まぎ－らわす	紛
まぎ－れる	紛
まさ－る	勝
まじ－える	交
まじ－わる	交
まず－しい	貧
またた－く	瞬
まった－く	全
まつ－り	祭
まつ－る	祭
まど－う	惑
まな－ぶ	学
まぬか－れる	免
まね－く	招
まも－る	守
まよ－う	迷
まる－い	丸
まる－い	円
まる－める	丸
まわ－す	回
まわ－り	周
まわ－る	回
ま－う	舞
ま－かす	負
ま－がる	曲
ま－く	巻
ま－ける	負
ま－げる	曲
ま－ざる	交
ま－ざる	混
ま－じる	交
ま－じる	混
ま－す	増
ま－ぜる	交
ま－ぜる	混
ま－つ	待
みが－く	磨
みじか－い	短
みじ－め	惨
みずか－ら	自
みだ－す	乱
みだ－れる	乱
みちび－く	導
みっ－つ	三
みつ－ぐ	貢
みと－める	認
みにく－い	醜
みの－る	実
み－える	見
み－せる	見
み－たす	満
み－ちる	満
み－つ	三
み－る	見
み－る	診
むか－える	迎
むく－いる	報
むす－ぶ	結
むずか－しい	難
むっ－つ	六
む－かう	向
む－く	向
む－ける	向
む－こう	向
む－す	蒸
む－つ	六
む－らす	蒸
む－れ	群
む－れる	群
む－れる	蒸
めぐ－む	恵
めぐ－る	巡
めずら－しい	珍
め－す	召
もう－ける	設
もう－す	申
もぐ－る	潜
もち－いる	用
もっと－も	最
もっぱ－ら	専
もと－める	求
もど－す	戻
もど－る	戻
もよお－す	催
も－える	燃
も－しくは	若
も－す	燃
も－つ	持
も－やす	燃
も－らす	漏
も－り	守
も－る	漏
も－る	盛
も－れる	漏
やさ－しい	優
やさ－しい	易
やしな－う	養
やす－い	安
やす－まる	休
やす－む	休
やす－める	休
やっ－つ	八
やと－う	雇
やど－す	宿
やど－る	宿
やぶ－る	破
やぶ－れる	敗
やぶ－れる	破
やわ－らか	柔
やわ－らか	軟
やわ－らかい	柔
やわ－らかい	軟
やわ－らぐ	和
やわ－らげる	和
や－く	焼
や－ける	焼
や－つ	八
や－む	病
や－める	辞
ゆず－る	譲
ゆた－か	豊
ゆだ－ねる	委
ゆる－い	緩
ゆる－す	許
ゆる－む	緩
ゆる－める	緩
ゆる－やか	緩
ゆ－う	結
ゆ－く	行
ゆ－く	逝
ゆ－さぶる	揺
ゆ－すぶる	揺
ゆ－する	揺
ゆ－らぐ	揺
ゆ－る	揺
ゆ－るぐ	揺
ゆ－れる	揺
ゆ－わえる	結
よご－す	汚
よご－れる	汚
よそお－う	装
よっ－つ	四
よろこ－ぶ	喜
よわ－い	弱
よわ－まる	弱
よわ－める	弱
よわ－る	弱
よ－い	善
よ－い	良
よ－う	酔
よ－せる	寄
よ－つ	四
よ－ぶ	呼
よ－む	詠
よ－む	読
よ－る	因
よ－る	寄
わか－い	若
わか－れる	別
わざわ－い	災
わす－れる	忘
わずら－う	患
わずら－う	煩
わずら－わす	煩
わた－す	渡
わた－る	渡
わら－う	笑
わる－い	悪
わ－かす	沸
わ－かつ	分
わ－かる	分
わ－かれる	分
わ－く	沸
わ－ける	分
わ－る	割
わ－れる	割
